北京大学 www.pku.edu.cn
中国人民大学	www.ruc.edu.cn
清华大学 www.tsinghua.edu.cn
北京航空航天大学	www.buaa.edu.cn
北京理工大学	www.bit.edu.cn
中国农业大学	www.cau.edu.cn
北京师范大学	www.bnu.edu.cn
中央民族大学	www.muc.edu.cn
南开大学	www.nankai.edu.cn
天津大学	www.tju.edu.cn
大连理工大学	www.dlut.edu.cn
吉林大学	www.jlu.edu.cn
哈尔滨工业大学 www.hit.edu.cn
复旦大学 www.fudan.edu.cn
同济大学	www.tongji.edu.cn
上海交通大学 www.sjtu.edu.cn
华东师范大学	www.ecnu.edu.cn
南京大学 www.nju.edu.cn
东南大学	www.seu.edu.cn
浙江大学 www.zju.edu.cn
中国科学技术大学 www.ustc.edu.cn
厦门大学	www.xmu.edu.cn
山东大学	www.sdu.edu.cn
中国海洋大学	www.ouc.edu.cn
武汉大学	www.whu.edu.cn
华中科技大学	www.hust.edu.cn
中南大学	www.csu.edu.cn
中山大学	www.sysu.edu.cn
华南理工大学	www.scut.edu.cn
四川大学	www.scu.edu.cn
重庆大学	www.cqu.edu.cn
电子科技大学	www.uestc.edu.cn
西安交通大学 www.xjtu.edu.cn
西北工业大学	www.nwpu.edu.cn
兰州大学	www.lzu.edu.cn
国防科技大学	www.nudt.edu.cn
东北大学	www.neu.edu.cn
郑州大学	www.zzu.edu.cn
湖南大学	www.hnu.edu.cn
云南大学	www.ynu.edu.cn
西北农林科技大学	www.nwsuaf.edu.cn
新疆大学	www.xju.edu.cn
