人民网	www.people.com.cn
新华网	www.xinhuanet.com
中央人民广播网	www.cnr.cn
光明网	www.gmw.cn
国际在线	www.cri.cn
央视网	www.cctv.cn
求是理论网	www.qstheory.cn
中国日报	cn.chinadaily.com.cn
中青在线	www.cyol.net
中国经济网	www.ce.cn
解放军报	www.81.cn
中国改革报社	www.crd.net.cn
中国教育报	www.cepa.com.cn
中国教育电视台	www.centv.cn
科技日报	www.stdaily.com
人民邮电报社 	www.cnii.com.cn
民族画报社	www.mzhb.com
民族报社	www.mzb.com.cn
纪检监察报	csr.mos.gov.cn
中国社会报社	www.shehuiwang.cn
法制日报社	www.legaldaily.com.cn
中国财经报	www.cfen.com.cn
劳动保障新闻网	www.clssn.com
中国环境报社	www.cenews.com.cn
中国建筑报社	www.chinajsb.cn
中国交通新闻网	www.zgjtb.com
人民铁道报社	www.peoplerail.com
中国水利报	www.chinawater.com.cn
中国农村杂志社 	www.crnews.net
国际商报	www.comnews.cn
中国文化报	www.ccdy.cn
金融时报社	www.financialnews.com.cn
中国审计报社	www.icnao.cn
中国税务报社 	www.ctaxnews.com.cn
中国工商报社	www.cicn.com.cn
中国消费者报社	www.ccn.com.cn
中国质检报刊社	www.cqn.com.cn
体育资讯网	www.sportinfo.net.cn
中国医药报社	www.cnpharm.com
中国煤炭报社	www.ccoalnews.com
中国安全生产报社	www.aqsc.cn
中国信息报社	www.zgxxb.com.cn
中国知识产权报社	www.iprchn.com
中国旅游报社	www.toptour.cn
中国书画家杂志社	www.zgshjzz.com
中国新闻社	www.chinanews.com
新华每日电讯	mrdx.xinhuanet.com
经济参考报	jjckb.xinhuanet.com
中国科学报社	www.sciencenet.cas.cn
中国社会科学杂志	www.cssn.cn
工程院院刊	engineering.cae.cn
中国经济时报	jjsb.cet.com.cn
中国气象报社	www.zgqxb.com.cn
中国档案报社	www.zgdazxw.com.cn
中国电力报	www.cpnn.com.cn
中国烟草杂志社	www.echinatobacco.com
国际人才交流杂志	www.wetalent.com
中国海洋报社	www.oceanol.com
中国测绘报社	www.zgchb.com.cn
中国邮政快递报社	www.chinapostnews.com.cn
中国文物报社	www.ccrnews.com.cn
中国中医药报社	www.cntcm.com.cn
中国外汇管理杂志社	www.chinaforex.com.cn
京报网	www.bjd.com.cn
天津网	www.tianjinwe.com
解放网	www.jfdaily.com
华龙网	www.cqnews.net
河北新闻网	www.hebnews.cn
山西新闻网	www.sxrb.com
北国网	www.lnd.com.cn
中国吉林网	www.cnjiwang.com
黑龙江新闻网	www.hljnews.cn
新华报业网	www.xhby.net
浙江在线	www.zjol.com.cn
中安在线	www.anhuinews.com
今日福建	www.fujiangov.com
中国江西网	www.jxnews.com.cn
大众网	www.dzwww.com
大河网	www.dahe.cn
荆楚网	www.cnhubei.com
湖南在线	hunan.voc.com.cn
南方网	www.southcn.com
南海网	www.hinews.cn
四川日报网	www.sichuandaily.com.cn
多彩贵州网	www.gog.cn
云南网	www.yunnan.cn
陕西传媒网	www.sxdaily.com.cn
每日甘肃	www.gansudaily.com.cn
青海新闻网	www.qhnews.com
正北方网	www.northnews.cn
广西新闻网	www.gxnews.com.cn
中国西藏新闻网	www.chinatibetnews.com
宁夏新闻网	www.nxnews.net
新疆亚欧网	www.xjdaily.com
香港日报	www.hongkongdaily.net
澳门日报	www.macaodaily.com
